6	6				
.	#	#	.	.	.
.	.	.	.	#	#
.	#	#	.	.	.
.	#	.	.	#	.
.	#	.	#	#	.
.	#	.	.	.	.
