8	12										
.	.	.	.	.	.	.	.	#	#	#	#
#	.	#	#	#	#	#	.	#	#	#	#
#	.	#	#	#	#	#	.	#	#	#	#
#	.	#	#	#	#	#	.	#	#	#	#
#	.	#	#	#	#	#	.	#	#	#	#
#	.	#	#	#	#	#	.	#	#	#	#
#	.	.	.	.	.	.	.	.	.	#	#
#	#	#	#	#	#	#	#	#	.	.	.
