10	10								
.	.	.	.	.	.	.	.	#	#
.	#	#	#	#	#	#	.	.	.
.	#	#	#	#	#	#	#	#	.
.	#	#	#	#	#	#	#	#	.
.	.	.	.	.	.	.	#	#	#
.	#	#	#	#	#	.	#	#	#
.	.	#	#	#	#	.	#	#	#
#	#	.	.	.	.	.	#	#	#
#	#	.	#	#	#	#	#	#	#
#	#	.	.	.	.	.	.	.	.
