6	6				
.	#	#	.	.	.
.	.	.	.	#	#
.	#	#	.	.	#
.	#	.	.	#	.
.	#	.	#	#	.
.	#	#	.	.	.
